4,4,4,4,4,4,4,4,4,4,4,4,4,4,4,4,4,4,4,4,4,4,4,4,4,4,4,4,4,4,4,4
4,4,4,4,4,4,4,4,4,4,4,4,4,4,4,4,4,4,4,4,4,4,4,4,4,4,4,4,4,4,4,4
4,4,4,4,4,4,4,4,4,4,4,17,4,4,17,17,4,4,17,17,17,4,4,17,4,4,4,4,4,4,4,4
4,4,17,4,4,4,4,17,4,4,4,4,4,4,4,4,4,4,4,4,4,4,4,4,4,4,4,4,4,4,4,4
4,4,4,4,4,4,4,4,4,4,4,4,4,4,4,4,4,4,4,4,4,4,4,4,17,4,4,4,4,4,4,4
4,4,4,4,4,4,4,4,4,4,4,4,4,4,4,4,4,4,4,4,4,4,4,17,17,17,4,4,4,4,4,4
4,4,4,4,4,4,4,4,17,4,4,4,17,4,4,4,17,4,4,4,4,4,4,4,4,17,4,4,4,4,4,4
4,4,4,4,4,4,4,4,4,17,3,3,3,3,14,14,3,3,3,4,4,4,4,4,4,4,4,4,4,4,4,4
4,4,4,4,4,4,4,17,3,3,3,3,3,3,14,14,3,3,3,4,4,4,4,4,4,4,4,4,17,4,4,4
4,4,17,4,4,4,4,3,3,3,3,3,3,3,14,14,3,3,3,3,3,4,4,4,4,4,4,4,4,4,4,4
4,4,17,4,4,4,17,3,3,3,3,3,3,3,14,14,3,3,3,3,3,3,4,4,4,4,4,4,4,4,4,4
4,4,4,4,4,4,4,3,3,5,6,3,7,8,14,14,3,9,10,3,11,12,17,4,4,4,4,4,4,4,4,4
4,4,4,4,4,4,4,3,3,18,19,29,20,21,14,14,29,22,23,17,24,25,4,4,4,4,4,17,17,4,4,4
4,4,4,17,4,4,4,3,3,31,32,30,33,34,14,14,3,35,36,30,37,38,3,4,4,4,4,17,4,4,4,4
4,4,4,4,4,4,4,3,3,1,1,1,1,1,14,14,1,1,1,1,1,1,3,4,4,4,4,4,4,4,4,4
4,4,4,4,4,4,4,3,3,27,27,27,27,27,14,14,27,27,27,27,27,27,3,4,4,4,4,4,4,4,4,4
4,4,4,4,4,4,4,3,3,3,3,3,3,3,14,14,3,3,3,3,3,3,3,4,4,4,4,4,4,4,4,4
4,4,4,4,4,4,17,3,29,3,3,3,3,3,14,14,3,3,3,3,3,3,3,4,4,4,4,4,17,4,4,4
4,4,4,4,4,4,4,3,3,3,3,3,3,3,14,14,3,3,3,3,3,3,3,4,4,4,4,4,17,4,4,4
4,4,4,4,4,4,4,3,3,3,3,3,3,3,14,14,3,3,3,29,3,3,3,17,4,4,4,4,17,17,4,4
4,4,4,4,4,4,4,3,3,3,3,3,3,3,14,14,3,3,3,3,3,3,3,4,4,4,4,4,4,17,4,4
4,4,4,4,4,4,4,4,3,3,3,3,3,3,14,14,3,3,3,3,4,4,4,4,4,4,4,4,4,4,4,4
4,4,4,4,4,4,4,4,4,3,3,3,3,3,14,14,3,3,3,4,4,4,4,4,4,4,4,4,4,4,4,4
4,4,4,17,4,4,4,4,4,3,3,3,3,3,14,14,3,3,3,4,4,4,4,4,4,4,4,4,4,4,4,4
4,4,4,4,4,4,4,4,4,4,4,4,4,4,4,4,4,4,4,4,4,4,4,4,4,4,17,4,4,4,4,4
4,4,4,4,4,4,4,4,4,4,4,4,4,4,4,4,4,4,4,4,4,4,4,4,4,17,17,4,4,4,4,4
4,4,4,4,4,4,4,4,4,4,4,4,4,4,4,4,4,4,4,4,4,4,4,4,4,4,4,4,4,4,4,4
4,4,4,4,17,4,4,4,4,4,17,4,4,4,4,4,4,4,4,4,17,4,4,17,4,4,4,4,4,4,4,4
4,4,4,4,4,4,4,17,17,4,4,4,4,4,4,4,4,17,17,4,4,4,4,4,4,4,4,4,4,4,4,4
4,4,4,4,4,4,4,4,4,4,4,4,4,4,4,4,17,17,4,4,4,4,4,4,4,4,4,4,4,4,4,4
4,4,4,4,4,17,4,4,4,4,4,4,4,4,17,17,17,4,4,4,4,4,4,4,4,4,4,17,4,4,4,4
4,4,4,4,4,4,4,4,4,4,4,4,4,4,4,4,4,4,4,4,4,4,4,4,4,4,4,4,4,4,4,4
