4,5,6,3,3,3,7,8,3,3,3,9,10,3,3,3,3,3,3,3,3,3,3,3,3,3,3,3,3,3,3,3
4,18,19,16,16,16,20,21,16,16,16,22,23,16,16,16,16,16,3,4,3,3,3,3,3,3,3,3,3,3,3,3
17,31,32,30,3,3,33,34,30,3,3,35,36,30,3,3,3,16,3,3,3,3,3,3,3,3,3,3,3,3,3,3
17,0,1,1,1,1,1,1,1,1,1,1,1,1,2,3,3,16,3,29,3,3,3,3,3,3,3,3,3,3,3,3
17,26,27,27,27,27,27,27,27,27,27,27,27,14,15,5,6,16,3,3,3,3,3,3,3,3,3,3,3,3,3,3
17,3,3,3,3,3,3,3,3,3,3,3,3,13,15,18,19,16,3,3,3,3,3,3,3,3,3,3,3,3,3,3
4,3,3,3,3,3,3,3,3,3,3,3,3,13,15,31,32,16,3,3,3,3,3,29,3,3,3,3,3,3,3,3
4,3,3,3,3,3,3,3,3,3,3,3,3,13,14,14,15,4,3,3,3,3,3,3,3,3,3,3,3,3,3,3
17,3,3,3,3,3,3,3,3,3,3,3,3,13,15,4,4,4,3,29,3,3,3,3,3,3,3,3,3,3,3,3
4,3,3,3,3,3,3,3,3,3,3,3,3,13,15,4,17,3,3,3,3,3,3,3,3,3,3,3,3,3,3,3
17,3,3,3,3,3,3,3,3,3,3,3,3,13,15,4,17,17,3,3,3,3,3,3,3,3,3,3,3,3,11,12
4,3,3,3,3,3,3,3,3,3,3,3,3,13,15,4,17,17,4,4,4,4,4,4,4,4,4,4,4,4,24,25
4,3,3,3,3,3,3,3,3,3,3,3,3,13,15,17,4,4,4,17,17,17,17,17,17,17,17,17,17,30,37,38
4,3,3,3,3,3,3,3,3,3,3,3,3,13,14,14,14,14,14,14,14,14,14,14,14,14,14,14,14,14,14,4
17,3,3,3,3,3,3,3,3,3,3,3,3,13,14,14,14,14,14,14,14,14,14,14,14,14,14,14,14,14,14,4
4,3,3,17,3,3,17,3,3,17,30,3,3,13,15,3,3,3,3,3,3,3,3,3,3,3,3,3,3,4,4,4
4,3,3,17,3,3,17,3,3,17,3,3,3,13,15,3,3,3,3,3,3,3,3,3,3,3,3,3,4,4,3,3
4,3,3,17,3,3,17,3,3,17,3,3,3,13,15,3,3,3,3,3,3,3,3,3,3,3,4,17,4,3,3,3
4,3,3,17,3,3,17,3,3,17,3,3,3,13,15,3,3,3,3,3,3,3,3,3,3,17,4,3,3,3,3,3
4,3,3,17,3,3,17,3,29,17,3,3,3,13,15,3,17,17,17,17,9,10,3,3,4,4,3,3,3,3,3,3
4,3,3,17,3,3,17,3,3,17,3,3,3,13,15,3,17,17,17,17,22,23,3,17,4,3,3,3,3,3,3,3
4,3,3,17,3,3,17,3,3,17,3,3,3,13,15,3,17,17,17,30,35,36,17,17,3,3,3,3,3,3,3,3
17,3,3,3,3,3,3,3,3,3,3,3,3,13,14,1,1,1,1,1,1,2,4,3,3,3,3,3,3,3,3,3
4,3,3,3,3,3,3,3,3,3,3,3,3,13,14,27,27,27,27,27,27,28,17,3,3,3,3,3,3,3,3,3
4,3,3,3,3,3,3,3,3,3,3,3,3,13,15,3,3,29,3,3,3,3,17,3,3,3,3,3,3,3,3,3
4,3,3,3,3,3,3,3,3,3,3,3,3,13,15,3,3,3,3,3,3,17,4,3,3,3,3,3,3,3,3,3
4,3,3,3,3,3,3,3,3,3,3,3,3,13,15,3,3,3,3,3,3,4,3,3,3,3,3,3,3,3,3,3
17,17,3,3,3,3,3,3,3,3,3,3,3,13,15,3,3,3,3,3,3,17,3,3,3,3,3,3,3,3,3,3
4,3,3,3,3,3,3,3,3,3,3,3,3,13,15,29,3,29,3,3,3,4,3,3,3,3,3,3,3,3,3,3
4,3,3,3,3,3,3,3,3,3,3,3,3,13,15,3,3,3,3,3,4,4,3,3,3,3,3,3,3,3,3,3
4,3,3,3,3,3,3,3,3,3,29,3,3,3,3,3,3,3,29,3,17,3,3,3,3,3,3,3,3,3,3,3
4,4,17,4,4,4,4,4,4,17,4,4,17,4,17,4,4,17,4,4,4,3,3,3,3,3,3,3,3,3,3,3
